::FORM_IGRA
btnEndTurn = End t&urn
btnFlote = &Fleet
btnFlotaPokret = Move
btnPlanetInfo = &Details
btnPoruke := "&News (" # P BR_PORUKA # ")"
btnSpremi = &Save
btnTech = &Technologies
btnUcitaj = &Load
lblBrojKruga := # D + KRUG 1 # ? = KRUG 0 : "st" ? = KRUG 1 : "nd" ? = KRUG 2 : "rd" ? > KRUG 2 : "th" " turn"

flotaObrana = Defense
zvjNeistrazeno = Unknown

::KOLONIJA
Civilna_Gradnja = Civil construction
Vojna_Gradnja = Military construction
jedInd = ind
lblRazvoj := "Develpoment: "

plBrFarmera = Farmers
plBrOdrz = Maintenance
plBrRudara = Miners
plMinDubina = Deep
plMinOstvareno = Mined
plMinPovrsina = Surface
plNenaseljeno = Uninhabited
plPopMax = Maximum
plPopulacija = Population
plPromjenaPop = Change
plRadnaMjesta = Work places

gradNikad = Never
gradPoKrugu := ? < BR_ZGRADA 10 : # D1 BR_ZGRADA # ? >= BR_ZGRADA 10 : # P BR_ZGRADA # " per turn"
gradVrijemeDec := "In " # D1 BR_KRUGOVA # " turn" ? != 1 INT DECIMALA : "s"
gradVrijemePref := "In " # P BR_KRUGOVA # " turn" ? | < BR_KRUGOVA 20 != 1 INT MOD BR_KRUGOVA 10 : "s"

groupPoStan = Per populant
HranaPoStan = Food
IndustrijaPoStan = Industry
OdrzavanjePoStan = Maintenance
RazvojPoStan = Development
RudePoStan = Ores
